..........@@..##..####....
..........@@..##..####....
...#########..##.....X....
...#########..##..........
......#...##..####..%%%%%%
......#...##..####..%%%%%%
...#...X......@@..%%%%%%%%
...#..........@@..%%%%%%%%
...#..######@@####%%%%##@@
...#..######@@####%%%%..@@
..######@@....##..%%%%.X.#
........@@....##..%%%%...#
.#######..@@%%%%%%%%%%....
.#######..@@%%%%%%%%%%....
.X....@@....%%%%%%%%%%##..
......@@....%%%%%%%%%%##..
@@##..%%%%%%%%@@%%%%%%##..
@@##..%%%%%%%%@@%%%%%%##..
.###%%%%%%%%%%........###.
.###%%%%%%%%%%........###.
..##%%%%........@@######..
..##%%%%..........######..
....%%%%..........##...#..
....%%%%...####...##...#..
....%%%%...#..#...........
..##%%%%...#..#...........