......##............%%....
......##..........@@%%....
##............%%.@@@@...##
##..........@@%%.@@@@...##
........%%.@@@@...@@%%....
......@@%%.@@@@.....%%....
.....@@@@...@@%%..........
X....@@@@.....%%..X.......
......@@%%................
........%%................
......%%..%%..%%..%%......
......%%@@%%..%%@@%%......
@@##...@@@@....@@@@...##@@
@@##...@@@@....@@@@...##@@
......%%@@%%..%%@@%%......
..X...%%..%%..%%..%%......
..........................
........@@......@@........
##.....@@@@....@@@@.....##
##.....@@@@....@@@@.....##
##....%%@@%%..%%@@%%....##
##....%%..%%..%%..%%....##
..........................
....##.....####.....##....
....####...#..#...####....
....####...#..#...####....