......................X...
...........X..............
...#####............#####.
...#..##............##..#.
.###....##..%%%%..##.....#
.#......##..%%%%..##.....#
##......##%%%%%%%%##.....#
##...X..##%%%%%%%%##.....#
##.....###%%@@@@%%###...##
##.....###%%@@@@%%###...##
.#....##~~~~~~~~~~~~######
.#######~~~~~~~~~~~~######
..######@@@@##@@@@#######.
..######@@@@##@@@@#######.
....####@@..##..@@#####...
....####@@..##..@@#####...
....###################...
....###################...
##%%######@@@@########%%##
##%%......@@@@........%%##
##%%%%%%%%%%%%%%%%%%%%%%##
##%%%%%%%%%%%%%%%%%%%%%%##
....%%%%%%......%%%%%%%%..
....%%%%%%.####.%%%%%%%%..
......#....#..#.....#.....
......#....#..#.....#.....