....##....##......##......
....##....##..##..##......
%%######..##......###.....
%%######..##..@@..###.....
%%%%%%....##..##..##...##.
%%%%%%........##.......##.
%%~~~~~~~~~~~~~~~~~~~~..~~
%%~~~~~~~~~~~~~~~~~~~~..~~
..##................X.....
..##........####..........
....##.....###########@@@@
....##.....#####..##......
####..##...#####%%##....##
####..##...#####%%##@@@@##
X.....@@......%%%%%%%%....
......@@..@@..%%%%%%%%....
~~~~..~~~~~~~~~~..~~~~~~~~
~~~~..~~~~~~~~~~..~~~~~~~~
%%%%...#...............X..
%%%%...#....####..........
%%%%##..#......#......##..
%%%%##..#......#..@@####..
%%..##..#.........##..##..
%%@@##..#..####.......##..
...........#..#.......##..
...........#..#...##......